,id,名称,胜,平,负,胜球,输球,净胜球,积分
0,33,本菲卡,18,5,7,62,45,17,59
1,31,马赛,8,10,12,51,63,-12,34
2,25,勒沃库森,4,11,15,43,72,-29,23
3,29,摩纳哥,18,5,7,61,33,28,59
4,36,川崎前锋,12,7,11,51,45,6,43
5,22,里斯本竞技,25,5,0,89,30,59,80
6,35,河床,17,6,7,48,34,14,57
7,21,里昂,6,8,16,35,58,-23,26
8,30,广州恒大,12,8,10,70,56,14,44
9,34,博卡,17,7,6,45,21,24,58
10,24,浙江绿城,5,3,22,45,94,-49,18
11,32,波尔图,15,6,9,88,82,6,51
12,27,狼队,5,8,17,39,57,-18,23
13,26,西汉姆联,8,2,20,49,70,-21,26
14,23,莱比锡,8,6,16,39,63,-24,30
15,28,罗马,10,7,13,70,62,8,37
