,id,名称,胜,平,负,胜球,输球,净胜球,积分
0,31,马赛,19,5,6,57,32,25,62
1,33,本菲卡,15,4,11,56,40,16,49
2,30,广州恒大,9,7,14,48,58,-10,34
3,36,川崎前锋,15,7,8,66,51,15,52
4,26,西汉姆联,6,4,20,44,76,-32,22
5,23,莱比锡,6,3,21,41,72,-31,21
6,27,狼队,7,12,11,38,43,-5,33
7,25,勒沃库森,7,5,18,40,68,-28,26
8,35,河床,14,7,9,44,39,5,49
9,21,里昂,8,4,18,34,52,-18,28
10,22,里斯本竞技,21,5,4,83,41,42,68
11,32,波尔图,8,7,15,59,85,-26,31
12,29,摩纳哥,16,6,8,72,34,38,54
13,24,浙江绿城,10,3,17,53,78,-25,33
14,34,博卡,16,7,7,38,21,17,55
15,28,罗马,17,6,7,69,52,17,57
